1.	Prince: "Sign O' the Times" (Paisley Park)	54
2.	Suzanne Vega: "Luka" (A&M)	53
3.	Los Lobos: "La Bamba" (Slash)	46
4.	Prince: "I Could Never Take the Place of Your Man"/"Hot Thing" (Paisley Park)	32
5.	M/A/R/R/S: "Pump Up the Volume" (4th & B'way)	30
6.	Grateful Dead: "Touch of Grey" (Arista)	28
Bruce Springsteen: "Brilliant Disguise"/"Lucky Man" (Columbia)	28
R.E.M.: "The One I Love" (I.R.S.)	28
9.	Prince: "U Got the Look"/"Housequake" (Paisley Park)	27
10.	Bruce Springsteen: "Tunnel of Love" (Columbia)	25
X: "Fourth of July"/"Positively Fourth Street" (Elektra)	25
12.	R.E.M.: "It's the End of the World As We Know It (And I Feel Fine)" (I.R.S.)	24
Stevie Wonder: "Skeletons" (Motown)	24
14.	Eric B. & Rakim: "I Know You Got Soul" (4th & B'way)	23
15.	LeVert: "Casanova" (Atlantic)	21
U2: "With or Without You" (Island)	21
17.	Bangles: "Hazy Shade of Winter" (Def Jam)	19
18.	Public Enemy: "Bring the Noise" (Def Jam)	18
U2: "I Still Haven't Found What I'm Looking For" (Island)	18
20.	George Michael: "I Want Your Sex" (Columbia)	17
The Replacements: "Alex Chilton" (Sire)	17
22.	Crowded House: "Don't Dream It's Over" (Capitol)	16
Fleetwood Mac: "Big Love"/"You and I" (Warner Bros.)	14
Michael Jackson: "The Way You Make Me Feel" (Epic)	14
George Michael: "Faith" (Columbia)	14
Alexander O'Neal: "Fake" (Tabu)	14