1.	Run-D.M.C.: "Walk This Way" (Profile)	78
2.	Cameo: "Word Up" (Atlanta Arista)	68
3.	Prince & the Revolution: "Kiss"/"Love Or Money" (Paisley Park)	64
4.	Peter Gabriel: "Sledgehammer" (Geffen)	39
5.	Billy Bragg: "Levi Stubbs' Tears" (Go! Discs import)	27	*
R.E.M.: "Fall On Me" (I.R.S.)	27
Timbuk 3: "The Future's So Bright, I Gotta Wear Shades" (I.R.S.)	27
8.	Steve Winwood: "Higher Love" (Warner Bros.)	24
9.	Public Image Ltd.: "Rise" (Elektra)	23
Talking Heads: "Wild Wild Life" (Sire)	23
11.	Janet Jackson: "Nasty" (A&M)	22
12.	Beastie Boys: "Fight For Your Right (To Party)" (Def Jam)	20
The Smithereens: "Blood and Roses"/"Behind the Wall of Sleep" (Enigma)	20
Bruce Springsteen: "War"/"Merry Christmas Baby" (Columbia)	20
15.	Pretenders: "Don't Get Me Wrong" (Sire)	19
16.	Bangles: "Walk Like An Egyptian" (Columbia)	18
Ciccone Youth: "Into the Groovey"/"Burnin' Up"/"Tuff Titty Rap" (New Alliance/Blast First import)	18	*
Pet Shop Boys: "West End Girls" (EMI America)	18
Timex Social Club: "Rumours"/"Vicious Rumours" (Danya)	18
20.	James Brown: "Living In America" (Scotti Brothers)	17	**
Madonna: "Papa Don't Preach" (Sire)	17
22.	Robert Palmer: "Addicted To Love" (Island)	16
23.	Bangles: "Manic Monday" (Columbia)	15
Bruce Hornsby and the Range: "The Way It Is" (RCA Victor)	15
Rolling Stones: "One Hit (To the Body)" (Rolling Stones)	15