1.	Ian Dury & the Blockheads: "Hit Me With Your Rhythm Stick"/"Reasons to Be Cheerful, Pt. 3" (Stiff/Epic)	29	*
2.	M: "Pop Musik" (Sire)	26
3.	Donna Summer: "Hot Stuff" (Casablanca)	22	*
4.	Sister Sledge: "We Are Family"/"He's the Greatest Dancer" (Cotillion)	20	*
The Pretenders: "Stop Your Sobbing"/"The Wait" (Real import)	20
6.	Fleetwood Mac: "Tusk" (Warner Bros.)	17
The Knack: "My Sharona" (Captiol)	17
8.	Blondie: "Dreaming" (Chrysalis)	16
9.	The Brains: "Money Changes Everything" (Gray Matter)	15
The Flying Lizards: "Money" (Virgin)	15
The Specials: "Gangsters" (2 Tone import)	13
12.	Michael Jackson: "Don't Stop 'Til You Get Enough" (Epic)	12
The Pretenders: "Kid" (Kid import)	12
The Records: "Starry Eyes" (Virgin)	12
Talking Heads: "Life During Wartime" (Sire)	12
16.	Lester Bangs: "Let It Blurt" (Spy)	11	**
Chic: "Good Times" (Atlantic)	11
Dave Edmunds: "Girls Talk" (Swan Song)	11
Funkadelic: "(Not Just) Knee Deep" (Warner Bros.)	11
Peaches & Herb: "Reunited" (Polydor)	11
Donna Summer: "Bad Girls" (Casablanca)	11
22.	Gang of Four: "At Home He's a Tourist"/"It's Her Factory" (EMI import)	10
Robin Lane & the Chartbusters: "Why Do You Tell Lies"/"When Things Go Wrong" (Deli Platters EP)	10
Nick Lowe: "Cruel to Be Kind" (Columbia)	10
McFadden & Whitehead: "Ain't No Stoppin' Us Now" (Philadelphia International)	10	*
Sugarhill Gang: "Rapper's Delight" (Sugarhill)	10	***
