January 05	Love Me Down	Freddie Jackson
January 12
January 19	The First Time	Surface
January 26	Love Makes Things Happen	Pebbles
February 02
February 09	You Don t Have To Worry	En Vogue
February 16	I ll Give All My Love To You	Keith Sweat
February 23	Gonna Make You Sweat	C+C Music Factory
March 02	All The Man That I Need	Whitney Houston
March 09
March 16	Written All Over Your Face	The Rude Boys
March 23	I Like The Way (The Kissing Game)	Hi-Five
March 30
April 06	Do Me Again	Freddie Jackson
April 13	Wrap My Body Tight	Johnny Gill
April 20	Whatever You Want	Tony Toni Tone
April 27
May 04	I m Dreamin (From "New Jack City")	Christopher Williams
May 11	Call Me	Phil Perry
May 18	It Should ve Been You	Teddy Pendergrass
May 25	Kissing You	Keith Washington
June 01	I Wanna Sex You Up (From "New Jack City")	Color Me Badd
June 08
June 15	Power Of Love/Love Power	Luther Vandross
June 22
June 29	How Can I Ease The Pain	Lisa Fischer
July 06
July 13	Exclusivity	Damian Dame
July 20
July 27	Baby I m Ready	Levert
August 03	Summertime	D.J. Jazzy Jeff
August 10	I Can t Wait Another Minute	Hi-Five
August 17	Can You Stop The Rain	Peabo Bryson
August 24
August 31	Addictive Love	BeBe
September 07
September 14	Let The Beat Hit Em	Lisa Lisa
September 21	Don t Wanna Change The World	Phyllis Hyman
September 28	I Adore Mi Amor	Color Me Badd
October 05	Running Back To You	Vanessa Williams
October 12
October 19	Romantic	Karyn White
October 26	It s So Hard To Say Goodbye To Yesterday	Boyz II Men
November 02	Emotions	Mariah Carey
November 09	Forever My Lady	Jodeci
November 16
November 23	Closer Than Close	Peabo Bryson
November 30	Are You Lonely For Me	The Rude Boys
December 07	I'll Take You There	BeBe & CeCe Winans
December 14	Private Line	Gerald Levert
December 21	I Love Your Smile	Shanice
December 28