1.	Quad City DJs: "C'mon N' Ride It (The Train)" (Atlantic/Big Beat)	34
2.	Beck: "Where It's At" (DGC)	31
Smashing Pumpkins: "1979" (Elektra)	31
4.	Oasis: "Wonderwall" (Epic)	30	*
Pulp: "Common People" (Island)	30	*
6.	Busta Rhymes: "Woo Hah!! Got You All in Check" (Elektra)	24
7.	The Chemical Brothers: "Setting Sun" (Astralwerks)	21
8.	Beck: "Devils Haircut" (DGC)	20
Blackstreet: "No Diggity" (Interscope)	20
Primitive Radio Gods: "Standing Outside a Broken Phone Booth With Money in My Hand" (Ergo/Columbia)	20
11.	Tupac & Dr. Dre: "California Love" (Death Row/Interscope)	18
12.	Butthole Surfers: "Pepper" (Capitol)	17
13.	Everclear: "Santa Monica" (Capitol)	16	*
Fugees: "Ready or Not" (Ruffhouse/Columbia)	16
Garbage: "Stupid Girl" (Almo Sounds)	16
Los Del Rio: "Macarena (Bayside Boys Mix)" (RCA)	16	*@
17.	Sheryl Crow: "If It Makes You Happy" (A&M)	15
18.	The Cardigans: "Lovefool" (Mercury)	13
Fugees: "Killing Me Softly" (Ruffhouse/Columbia)	13
20.	Fugees: "Fu-Gee-La" (Ruffhouse/Columbia)	12	*
Nas: "If I Ruled the World" (Columbia)	12
Oasis: "Champagne Supernova" (Epic)	12
23.	Eels: "Novocaine for the Soul" (Dreamworks)	10
Everything but the Girl: "Missing" (Atlantic)	10	*
Garbage: "Only Happy When It Rains" (Almo Sounds)	10	*
Whitney Houston: "Exhale (Shoop Shoop)" (Arista)	10	*
Rage Aginst the Machine: "Bulls on Parade" (Epic)	10
Underworld: "Born Slippy" (TVT)	10	*