1.	Arrested Development: "Tennessee" (Chrysalis)	100
2.	House of Pain: "Jump Around" (Tommy Boy)	40
3.	Kris Kross: "Jump" (Ruffhouse/Columbia)	37
4.	En Vogue: "My Lovin' (You're Never Gonna Get It)" (EastWest)	34
5.	Arrested Development: "People Everyday" (Chrysalis)	26
Cypress Hill: "How I Could Just Kill a Man"/"The Phuncky Feel One" (Ruffhouse/Columbia)	26	*
7.	Sir Mix-a-Lot: "Baby Got Back" (Def American)	25
8.	U2: "One" (Island)	24
9.	The KLF: "Justified and Ancient" (Arista)	23	*
10.	Sophie B. Hawkins: "Damn, I Wish I Was Your Lover" (Epic)	22
11.	L7: "Pretend We're Dead" (Slash)	20
12.	TLC: "Ain't 2 Proud 2 Beg" (LaFace)	19
13.	R.E.M.: "Drive" (Warner Bros.)	16
14.	Das Efx: "They Want Efx" (EastWest)	15
K.D. Lang: "Constant Craving" (Sire/Warner Bros.)	15
Prince and the New Power Generation: "Sexy M.F." (Paisley Park/Warner Bros.)	15
Red Hot Chili Peppers: "Under the Bridge" (Warner Bros.)	15
Pete Rock & CL Smooth: "They Reminisce Over You (T.R.O.Y.)" (Elektra)	15
Wreckx-N-Effect: "Rump Shaker" (MCA)	15
20.	Ministry: "Jesus Built My Hot Rod" (Sire/Warner Bros.)	13	*
Nirvana: "Lithium" (DGC)	13
Lisa Stansfield: "Real Love" (Arista)	13
Utah Saints: "Something Good" (London)	13
24.	Arrested Development: "Revolution" (Chrysalis)	12
The Cure: "Friday I'm in Love" (Elektra/Fiction)	12
Madonna: "Erotica" (Maverick/Reprise)	12
Bruce Springsteen: "Human Touch" (Columbia)	12
Paul Westerberg: "Dyslexic Heart" (Epic)	12